1111111111111111111111111111111111
1E00000000F0000C00000C000010000001
1010010100100000101001000000010101
10100100101010100010010F0000010101
1P0000000C00C0000000000000E00000C1
1111111111111111111011111111111111
110000000C00C0000000000000E00000C1
110000000C00C0000000000000E00000C1
110000000C00C0000000P00000E00000C1
110000000C00C0000000000000000000C1
110000000C00C0000000000000E00000C1
1111111111111111111111111111111111