1111111111111111111111111111111111
1C0000000010000C00000C000000000001
1010010100100000101001000000010101
1010010010101010001001010000010101
1P0000000C00C0000000000000100000C1
1111111111111111111011111111111111
110000000000C0000000100000100000C1
110000000CCCC0000011000000100000C1
110000000C01C0000000000000100000C1
110000000C10C000F000000000000000C1
11CCCCCCCFECCCCCCC1CCCCCCCC0CC0CC1
1111111111111111111111111111111111