1111111111111111111111111111111111
1EC1CCCCCC10000C00000CCCCCCCCE0CC1
1CCCC10100100000101001CCCC0001C101
1C1001001010101CCC10010C000001C101
1PCCCCCCCCCCCCCCCCCFCCCCCCCCCCCCC1
1111111C111111C111101111111C111111
1CCCCCCCC1001CCCC1000100001C0010C1
1CCCCCCCC1001CCCCCC100000010000011
1C00CCCCC100001000001CCCCCCCCC0C11
1C11C0000000111000011111111CCCCC11
1CCCCCCCCCCCFECCCCCCCCC1CCCCCCCCC1
1111111111111111111111111111111111