1111111111111111111111111111111111111111
1E00000000F0000C00000C0000000E0001111111
1010010100100000101001000000010101111111
10100100101010100010010F0000010101111111
1P0000000C00C0000000000000E0000011111111
1111111111111111111011111111111111111111
11000000010010000000000000E0000011111111
11000000010010000000000000E0000011111111
11000000010010000000000000E0000011111111
1100000001001000000000000000000011111111
11000000010010000000000000E0000011111111
1111111111111111111111111111111111111111